1111111111111111111111111111111111111111111111111111111111111111111111111111111111111111111111111
1111111111111111111111111111111111111111111111111111111111111111111111111111111111111111111111111
1111111111111111111111111111111111111111111111111111111111111111111111111111111111111111111111111
0000000000000000333333333330000000000000011111111111111111111111111111111111111111111111111111111
0000000000000000000000000000000000000000000000111111111111111111111111111111111111111111111111111
1111111111111100000000000000000000000000000000000000000000111111111111111111111111111111111111111
1111111111111111111222111111222133312222111000000000000000111111111111111111111111111111111111111
1111111111111111111111111111111111111111111111111111111100111111111111111111111111111111111111111
1111111111111111111111111111111111111111111111111111111100111111111111111111111111111111111111111
1111111111111111111111111111111111111111111111111111111100111111111111111111111111111111111111111
1111111111111111111111111111111111111111111111111111111100111111111111111111111111111111111111111
1111111111111111111111111111111111111111111111111111111100111111111111111111111111111111111111111
1100000000000000000000000000000000000000000000000000000000111111111111111111111111111111111111111
1100000000000000000000000000000000000000000000000000000000000000000000110000000000000000000000011
1111111111111111111111111111111111111111111111111111111100000000000000110000000000000000000000011
1111111111111111111111111111111111111111111111111111111133111111111100111111111111111110401110011
1111111111111111111111111111111111111111111111111111111133111111111100111111111111111111111110011
1111111111111111111111111111111111111111111111111111111133111111111100111111111111111111111110011
1111111111111111111111111111111111111111111111111111111111111111111100000000000000000000000000011
1111111111111111111111111111111111111111111111111111111111111111111122111111111111111111111111111
1111111111111111111111111111111111111111111111111111111111111111111122111111111111111111111111111