0000000000000000000000000000000000000000000000
0000000000000000000000000000000000000000000000
0000000000000000000000000000000000000000000000
0000000000000000000000000000000000000000000000
0000000000000000000000000000000000000000000000
0000000000000000000000000000111000000000000000
0000000000000000000000000000111000000000000000
0000000000000000000000000000111000000000000000
1111111111000001111222222221111133111111111411
0001111111000000001222222221000133100000001110
0001111111000000001222222221000133100000000000
0001100011000000001111111111000133100000000000
0001100011000000001111111111000111100000000000
1111111111000000001111111111111111111111111111